20
20
-1
 % *               H
H####H             H
H    H   +  @ *    H
H    H   H######H* H
H*   H   H      H###
H####H---H----  H   
H    H   H   H +H % 
H    H   H   H#####H
H    H   H   H     H
H    H   H   H +   H
H    H   H   H###H##
H    H   H   H   H  
H  + H * H   H   H  
#########H---H   H *
####     H   H   ###
#  # + % H + H      
######H######H      
      H      H      
       H  +   H *   
####################