20
20
90
######              
                    
 %     +            
#####H####          
     H-------       
     H    +      @   
     H    ##H ####H#
     H    ##H     H 
     H    ##H     H 
     H    ##H     H 
+    H    ####H#####
##H###        H     
  H           H     
  H   % +   + H     
######H#######H     
      H       H     
     +H-------H     
    H###      #####H
 %+ H   %   *    + H
####################