15
15
80
#              
# *    %       
########H######
#       H------
#       H   ##H
# %     H   ##H
####H####   ###
#   H   +   *  
##########H####
#         H    
#      %  H----
#    H######   
#  * H   *  @  
###############
###############