18
16
100
#           %   H#
################H#
#               H#
#H    +         H#
#H################
#H               #
#H   %          H#
################H#
#               H#
#               H#
#H              H#
#H  * @   H     H#
#H#######H########
#H       H       #
#H  %    H    +  #
##################